31x41* o12
*1***************************************
*               *       * * *   * *     *
*     *** * ********* * * * * * * * * * *
*     *   *           *   * * * * * * * *
***** * * ***************** * * * *** ***
*   * * * *             * * * * * * * * *
*** * ***** *********** * * * * * * * * *
*   *   *   *           * *   * *   *   *
* * * * * *** *********** * *** * * * * *
* * * *   *               * *     * * * *
* * * * ***************** * * *** * * * *
* * * *       *           * * *   *   * *
* * * * ***   ************* * * * * *** *
* * * *           *     * *   * * *   * *
* * * * ***** *** * * *** *** ***** * * *
* * * *     *   *   * * *         * * * *
* * * * * * * * ******* * * ***   ***** *
* *   * * * * * *       * * *           *
******* * * * ********* * * * *** *******
*     * * * *             * *   *   *   *
***** * * * *** *****   *** *** *** * ***
*     *   * *     * *       *   * * *   *
* *** *** * * *   * *********** * * * * *
*   *     * * *     *           *   * * *
* * * * *** * ***** * *********** * * * *
* * * *     * *   * *           * *   * *
* * * ******* * *** ******* ***** *** ***
* * * *           * *     *     * *     *
* * * * ******* ********* ***** *** *   *
* *   *     *       *           *   *   *
***************************************2*